xiahua	刘佳华
zhangbk	张炳凯
linyuan	林原
ch_xin	辛潮
xiaowj	xiaowj
lisb	李思白
my_weng	翁谋毅
kczhang	张克诚
sjmo	莫斯嘉
jsjie	揭鉴
tangy	tangy
pengzhi	彭智
zenghua	曾华
cenjh12	岑建航
lisc	李述成
zxhu	胡宗祥
zengwei	zengwei
tangwei	唐伟
zt	zt
miaop	miaop
chend	陈冬
chendj	陈大俊
zhengz	郑泽
huqin	胡钦
weiji	weiji
wzz	吴忠振
chenx	陈鑫
wmy	翁谋毅
dchen	dchen
zwnie	聂志伟
pwmat	pwmat
tem	tem
YaokunYe	叶耀坤
ymhu	ymhu
myhu	胡明宇
wkm	wkm
zhengss	郑世胜
xchen	陈鑫
jhliu	刘佳华
yjliu	yjliu
zfChen	陈哲峰
wangz	王志
tz	tz
bkzhang	张炳凯
yjiang	江毅
zhangwt	张文韬
liangxh	梁先辉
lwcheng1	林伟成
yanggh	杨国浩
jyning	jyning
lsmo	李思墨
